1111111
100P001
1000001
100C001
10C0C01
1C000C1
10C0C01
100C001
1000001
100E001
1111111
