1111111
1P10001
1000001
100C001
10C0C01
1C0C0C1
10C0C01
100C001
1000001
1000001
100E001
1111111
