1111111
1000001
1000C01
1101001
100P101
11E0111
1111111
